4250000000
3062225422
7000006704
0425482227
2121734222
0627067000
0000425045
0000306276
2250300000
0062700000